abk	?	grey
ara	الفيل(el'feel)	blue
aze	fil	blue
bel	слон	red
bos	slon	red
bul	слон	red
cat	elefant	blue
cau	?	grey
ces	slon	red
cor	?	grey
cym	eliffant	blue
dan	elefant	blue
deu	elefant	blue
ell	ελέφαντας	blue
eng	elephant	blue
est	elevant	blue
eus	elefante	blue
fao	?	grey
fin	norsu	yellow
fra	éléphant	blue
fry	?	grey
gag	?	grey
gla	?	grey
gle	eilifint	blue
glg	elefante	blue
hrv	slon	red
hun	elefánt	blue
hye	փիղ(p'igh)	pink
isl	fíl	blue
ita	elefante	blue
kat	elephant	grey
kaz	?	grey
krl	?	grey
lav	zilonis	green
lig	?	grey
lit	dramblys	orange
ltz	?	grey
mkd	слон	red
mlt	iljunfant	blue
nap	?		grey
nld	olifant	blue
nor	elefant	blue
oss	?	grey
occ	?	grey
pms	?	grey
pol	słoń	red
por	elefante	blue
roh	?	grey
ron	elefant	blue
rus	слон	red
sar	?	grey
sco	?	grey
sic	?	grey
slk	slon	red
slv	slon	red
sme	?	grey
spa	elefante	blue
sqi	elefant	blue
srp	slon	red
swe	elefant	blue
tat	?	grey
tur	fil	blue
ukr	слон  red
ven	?     grey
xal	?	grey
